1111111111
1P000000C1
1001111001
1101C11101
1000000E01
1111111111
